████████████████H████████████
█              X X          █
█  $                        █
█              X X          █
█      +  P                 █
█                           █
█                           █
█████████████████████████████